30 31 32 33 32 32 32 29 29 30 30 31 30 30 29 28 28 25 25 22 20 21 22 23 25 28 30 31 33 34 33 32 30 30 30 30 30 28 28 28 29 29 29 29 29 28 29 30 31 32 32 32 34 34 34 35 35 34 34 33 32 32 32 33 
31 31 32 32 32 33 32 30 29 30 31 33 33 32 32 30 28 27 24 24 22 22 23 24 25 28 30 30 33 34 32 31 28 28 28 28 27 27 26 27 28 29 28 29 29 29 30 32 34 37 36 35 35 36 35 35 35 35 33 32 32 32 32 33 
34 32 32 33 34 32 31 30 30 30 32 35 35 34 34 33 30 29 27 24 22 19 21 23 24 27 30 31 32 32 30 29 26 26 26 25 25 25 25 26 28 29 28 28 30 30 32 33 36 37 37 37 38 38 37 37 37 37 35 33 33 33 33 33 
36 35 32 33 34 32 32 32 32 33 34 35 36 36 35 34 32 30 26 23 21 18 18 21 22 26 28 29 29 30 29 27 24 24 24 25 24 24 25 25 26 27 28 29 30 31 33 34 37 38 37 37 40 40 41 40 39 38 36 36 36 35 34 33 
36 34 34 33 34 35 34 34 35 37 37 36 37 37 35 35 32 30 26 22 21 18 17 19 21 24 27 28 27 27 28 26 24 23 23 22 21 22 24 26 25 25 27 28 29 29 33 36 38 38 38 37 40 42 44 42 41 42 40 39 39 37 35 32 
36 35 36 35 34 34 35 37 38 39 40 39 38 37 35 34 32 29 26 21 19 17 18 19 21 24 25 26 25 26 25 25 25 24 24 23 22 23 25 25 25 26 26 26 28 29 32 35 37 37 37 39 41 43 44 44 44 44 42 40 39 37 35 34 
36 36 37 36 36 36 37 38 39 40 39 38 36 35 33 32 31 27 24 20 18 17 19 20 22 24 25 25 24 25 26 25 25 24 24 23 23 23 24 25 25 26 25 25 28 30 31 35 39 38 39 39 42 44 45 44 46 44 43 41 39 36 36 36 
37 38 38 38 39 38 38 38 38 39 38 38 34 34 31 29 27 25 23 20 17 17 19 21 22 23 25 25 25 25 26 26 26 25 24 25 26 25 24 24 24 25 25 26 28 29 31 35 38 38 39 38 42 45 47 47 45 46 45 43 40 39 37 37 
37 38 38 40 41 40 38 39 40 39 39 37 34 33 31 28 25 24 22 19 17 16 19 21 23 24 26 27 26 24 24 24 25 25 25 25 26 26 25 25 26 25 26 27 29 30 31 34 38 40 39 39 42 44 47 47 46 46 46 44 41 40 40 39 
37 37 40 39 41 41 40 40 41 41 39 37 34 32 31 29 27 25 23 20 18 17 18 20 23 24 26 26 27 25 23 24 25 26 25 25 25 26 27 27 27 27 27 28 30 31 32 33 35 37 39 41 42 44 47 47 46 47 46 46 45 42 41 41 
35 36 39 40 41 40 41 41 42 42 40 38 35 33 32 30 28 27 23 21 19 18 18 21 22 26 26 26 27 26 25 24 24 26 26 26 26 27 28 27 27 27 27 31 32 31 31 31 34 36 39 41 43 44 46 47 45 45 47 46 46 43 41 40 
34 35 37 39 41 42 41 41 43 43 42 40 37 34 32 30 28 25 24 22 20 19 20 22 23 26 27 27 28 28 27 25 25 26 26 26 27 28 29 28 28 27 29 31 33 33 32 31 33 35 37 40 44 44 44 45 44 44 45 46 45 42 40 40 
37 37 38 39 41 42 41 41 42 40 43 42 39 35 33 30 28 26 24 24 22 21 23 24 25 27 28 30 31 31 29 27 28 28 27 28 28 29 29 29 29 28 30 31 33 33 33 32 33 34 36 38 42 45 45 44 45 44 43 41 40 39 38 38 
37 37 39 41 40 39 38 38 38 40 42 43 41 37 34 32 30 26 26 24 25 24 25 25 26 27 28 31 33 32 31 29 28 29 28 29 29 28 29 29 28 28 29 32 33 34 34 33 34 34 35 38 40 42 43 44 42 40 41 40 38 37 37 36 
36 37 39 41 40 39 37 36 38 38 41 42 42 40 36 33 32 27 26 25 24 25 25 26 26 27 28 30 32 32 32 31 28 28 27 27 28 28 28 29 28 29 30 32 31 32 33 33 33 34 34 36 40 40 41 41 40 39 37 37 36 34 32 34 
36 37 39 40 39 38 36 36 37 38 39 41 42 40 38 35 32 28 25 24 25 25 26 26 26 25 26 27 30 31 31 30 29 28 26 26 26 27 28 28 29 30 32 33 33 32 32 32 32 34 34 34 39 39 40 40 39 37 36 35 33 31 30 30 
35 36 38 38 39 38 36 36 37 37 38 40 40 40 38 36 32 29 26 25 25 26 26 26 26 25 26 26 28 31 30 31 29 28 26 27 25 26 27 28 29 30 33 33 33 32 32 32 32 32 32 35 38 38 38 38 36 35 34 32 31 30 28 29 
34 36 36 39 39 39 37 36 37 38 40 39 38 38 37 34 31 29 27 25 24 25 25 25 26 26 27 28 29 31 30 30 29 29 29 28 27 28 27 29 29 29 31 31 33 32 32 31 32 31 32 35 37 39 38 37 36 34 32 31 30 28 26 27 
34 34 35 36 39 39 39 39 40 39 40 40 38 36 34 33 31 29 26 24 23 22 24 25 27 28 29 30 31 31 30 31 31 30 30 29 29 28 27 28 29 29 30 30 31 31 30 30 31 31 30 34 36 39 38 36 35 33 31 30 29 27 25 26 
33 34 36 37 37 38 39 39 40 40 39 39 38 36 35 33 31 30 28 25 24 23 24 27 28 30 31 31 32 33 33 33 32 31 31 31 30 29 27 27 28 30 30 29 29 29 30 30 30 31 31 33 35 37 38 35 34 32 30 28 27 27 26 27 
31 33 35 36 36 38 38 39 39 39 38 38 38 36 35 35 33 30 29 26 25 25 25 28 29 33 34 35 36 35 35 35 35 32 32 32 32 31 29 28 30 31 30 30 31 31 30 31 30 32 31 33 34 36 36 34 32 30 28 26 27 26 27 27 
30 33 35 35 36 37 37 38 38 38 39 38 38 37 37 35 34 32 30 28 27 26 27 30 33 36 36 37 37 37 37 35 36 35 34 34 34 33 31 31 31 32 32 31 31 32 31 32 31 31 32 34 34 34 34 33 31 29 26 26 27 27 27 28 
32 33 35 36 36 36 36 38 38 37 38 37 39 38 38 37 34 33 32 31 30 30 30 32 34 38 38 39 39 38 39 38 38 36 36 37 35 33 34 32 33 34 34 32 31 30 30 31 31 30 30 31 32 32 31 30 30 28 27 28 28 27 27 27 
33 34 34 36 37 36 36 37 38 37 37 37 39 38 37 37 35 33 31 31 31 31 32 34 35 39 38 39 40 39 39 40 39 38 39 37 38 35 34 33 32 33 33 32 31 31 31 30 29 30 30 29 29 29 29 28 29 29 30 29 29 28 26 27 
34 35 34 35 36 36 35 35 35 35 36 37 39 38 37 36 34 32 30 30 31 32 32 34 37 38 39 39 38 37 39 39 38 38 38 38 38 36 34 32 33 33 30 30 30 29 28 27 27 28 28 28 28 28 28 29 30 30 31 31 31 30 28 27 
34 35 34 35 35 36 36 34 34 34 34 36 39 39 37 35 35 32 32 31 33 33 33 36 37 37 37 38 37 37 38 38 37 37 37 37 37 35 33 32 33 33 30 28 29 28 27 27 27 27 28 27 25 26 26 28 29 30 31 31 33 32 30 29 
34 35 33 34 34 34 33 32 33 33 35 36 38 39 38 35 35 33 33 34 34 34 34 38 39 38 37 38 38 37 37 36 35 36 37 37 36 35 33 32 33 31 30 30 30 29 29 28 28 27 26 25 24 24 26 27 28 29 31 32 33 34 32 30 
34 34 35 33 34 33 31 31 32 32 33 34 36 38 37 37 35 35 34 35 35 34 36 38 39 40 40 37 38 38 37 35 33 34 35 35 34 33 31 31 31 30 30 30 30 30 28 28 28 27 26 25 24 24 25 26 27 28 30 31 33 33 34 32 
34 34 35 33 33 32 30 29 29 31 33 34 35 36 38 37 35 36 36 36 36 37 38 40 41 40 40 40 38 36 36 34 35 35 34 34 33 31 31 31 32 32 31 30 31 30 29 29 28 28 26 26 25 25 25 25 26 28 30 32 33 34 34 34 
34 35 35 32 30 29 28 28 28 29 31 34 33 33 34 34 33 34 33 35 36 37 38 39 41 40 39 40 39 36 34 34 34 36 36 34 32 30 31 31 32 32 32 31 31 31 31 31 31 28 26 25 25 26 27 26 26 28 30 32 33 35 34 35 
34 34 33 31 29 27 26 26 25 27 29 32 32 31 32 31 31 32 32 33 35 37 38 37 38 37 39 39 38 36 33 33 33 33 33 32 30 30 30 31 30 30 31 31 31 32 32 34 33 30 27 26 25 25 25 27 29 30 31 31 32 34 35 35 
33 32 31 30 27 25 23 24 24 25 26 28 30 31 32 31 31 30 31 33 35 36 36 36 35 36 36 37 36 35 32 31 30 31 31 31 31 31 31 31 30 30 31 31 31 31 33 35 33 31 29 27 27 25 25 27 30 32 33 31 31 31 32 34 
32 31 31 29 26 23 22 23 23 24 25 26 28 29 30 31 31 30 30 32 35 36 36 35 34 34 35 36 35 34 32 30 29 28 29 29 30 31 31 31 30 32 32 33 32 31 32 33 32 31 30 29 27 27 27 28 30 33 33 30 29 29 30 31 
31 30 30 28 25 21 20 21 21 22 23 24 25 27 28 29 30 31 30 32 33 35 36 34 33 33 34 34 34 32 29 29 27 27 28 28 29 31 31 30 30 32 33 34 32 32 32 33 33 30 32 30 28 27 27 30 30 32 31 30 28 27 27 30 
31 29 27 26 23 21 20 19 21 20 20 22 22 23 25 28 28 29 31 33 33 34 34 31 31 30 31 32 31 29 28 25 25 24 25 26 30 32 31 29 30 31 33 35 34 32 32 32 33 32 31 29 29 27 28 31 31 31 30 29 27 27 28 29 
30 28 26 23 22 21 20 20 18 19 20 20 21 22 23 25 26 28 30 32 33 32 31 29 30 29 29 30 28 28 25 21 21 22 22 24 27 29 32 31 31 31 33 34 34 36 35 35 35 34 30 30 29 28 30 30 32 31 29 28 27 27 28 30 
28 27 25 24 22 22 21 20 18 17 18 20 21 21 21 23 25 28 29 31 32 31 30 28 28 27 26 28 28 26 24 21 21 21 22 22 27 29 31 32 30 31 32 35 35 38 36 37 37 34 33 31 30 29 29 30 31 30 29 28 29 30 30 31 
27 26 24 24 22 22 22 21 19 16 17 19 20 20 19 21 23 25 27 28 29 29 30 29 30 29 27 27 27 26 24 23 22 21 22 23 26 29 29 29 30 29 32 34 37 36 36 36 36 34 34 31 30 29 28 29 30 29 28 28 30 31 30 31 
26 26 25 23 23 22 22 22 19 17 17 17 18 18 18 17 19 22 24 25 28 29 30 30 31 29 28 28 27 25 24 24 23 23 24 24 26 27 29 28 27 27 30 33 36 36 35 35 36 34 34 31 30 29 28 29 30 30 28 28 29 32 31 31 
26 27 25 23 22 22 23 21 19 17 16 16 16 17 17 16 16 18 23 25 27 28 29 30 31 30 29 29 28 27 25 24 23 23 23 23 26 27 27 27 27 28 28 32 34 37 36 35 35 33 33 31 30 29 29 31 32 29 30 29 29 31 32 33 
26 26 26 25 23 22 22 21 20 18 17 16 16 17 17 17 16 17 21 24 27 27 27 29 30 30 29 28 27 27 26 26 26 26 24 25 27 27 27 26 26 27 28 30 33 37 37 36 35 33 33 30 29 29 30 31 32 30 28 28 29 31 33 33 
25 27 26 26 25 24 22 22 20 19 18 18 18 19 18 18 17 17 21 24 27 27 26 26 26 28 27 27 26 27 28 28 28 27 27 27 28 29 28 27 26 26 28 30 33 36 38 37 35 35 33 31 28 29 30 32 32 31 30 30 32 32 33 33 
25 26 28 28 28 26 25 22 21 22 21 19 19 19 19 19 18 19 21 24 26 26 26 26 25 25 26 25 26 27 27 28 29 28 29 29 30 30 29 27 26 26 28 30 33 36 37 37 35 35 32 30 27 29 29 30 30 31 32 32 32 32 32 35 
24 24 26 28 30 28 27 25 23 23 23 22 21 21 21 21 21 21 23 25 26 27 27 27 26 24 24 25 26 27 28 27 28 29 32 33 31 30 30 28 27 27 28 31 32 35 35 35 34 34 32 30 28 28 28 29 29 30 32 33 33 33 33 35 
25 24 25 28 29 29 28 25 25 25 26 24 24 24 25 25 26 25 25 26 27 27 28 28 27 25 25 25 26 26 27 26 28 30 31 31 31 31 29 28 27 26 29 30 33 34 35 34 32 33 31 29 28 28 29 28 28 29 33 35 34 35 36 36 
26 26 28 28 29 30 29 28 27 27 27 27 27 27 29 30 29 29 28 29 28 28 28 30 28 27 26 27 26 26 27 27 27 30 31 32 31 31 29 28 27 28 30 29 32 33 34 33 32 32 29 28 26 26 27 27 26 29 32 34 35 36 35 36 
28 28 29 29 30 31 31 29 28 28 28 29 29 30 33 32 32 31 32 31 30 30 29 30 29 30 29 27 28 27 28 29 28 30 32 34 32 32 29 29 30 29 30 30 31 31 31 32 31 29 27 26 23 23 24 25 26 29 30 33 33 34 34 36 
30 29 29 30 30 31 30 29 29 29 30 31 31 32 34 33 33 33 35 34 33 32 32 31 31 30 30 30 30 29 28 30 31 30 32 32 33 32 30 30 30 30 28 29 29 30 32 32 30 28 25 22 21 20 21 22 24 27 27 29 31 33 32 35 
30 30 30 31 31 29 29 31 31 30 30 30 32 34 35 35 33 33 35 36 36 34 34 33 32 31 31 31 30 29 29 30 30 29 29 30 33 32 30 30 31 29 28 28 28 30 31 30 28 26 23 20 19 19 19 20 22 24 26 28 28 28 31 32 
31 31 31 32 31 30 29 31 31 30 30 31 34 37 38 36 35 37 38 37 37 36 36 35 33 34 32 31 30 29 29 29 29 30 29 30 31 30 30 30 30 30 30 29 28 29 29 28 26 24 21 20 19 18 19 19 21 23 24 26 27 27 27 29 
31 31 30 32 31 31 29 29 31 30 32 33 35 37 37 37 38 39 39 39 38 39 38 37 37 36 34 34 33 30 30 29 28 29 29 30 31 31 30 30 30 31 31 31 30 30 29 28 25 23 21 21 20 20 20 21 22 24 24 25 25 26 26 26 
31 32 32 32 31 30 30 30 30 31 34 35 36 37 36 38 40 41 42 41 40 39 41 41 41 40 38 35 34 32 32 31 30 29 30 30 31 32 32 30 31 32 31 32 31 29 29 27 27 24 22 22 21 21 21 22 23 25 24 24 24 24 25 25 
30 32 33 32 31 30 30 31 32 33 36 36 36 38 36 37 40 44 44 42 42 41 43 43 43 43 43 41 38 37 34 32 31 31 31 32 34 33 32 31 31 31 31 31 31 30 29 29 27 25 23 22 23 23 22 23 24 25 25 26 25 24 25 24 
31 32 34 32 31 31 32 33 34 34 35 36 35 36 38 37 39 43 45 43 43 42 44 44 43 45 45 44 42 39 37 35 35 34 32 33 34 35 34 32 31 31 30 30 30 32 31 30 27 25 25 24 23 23 23 24 24 25 26 26 25 25 25 25 
32 33 33 32 31 30 31 34 37 36 35 35 35 36 39 39 39 42 44 44 43 41 41 42 43 44 46 44 42 41 39 39 38 37 36 37 38 36 35 33 32 31 30 30 31 32 31 30 28 26 25 26 24 23 23 24 23 25 27 27 27 26 26 27 
33 33 34 33 32 30 30 33 36 37 35 35 34 37 39 40 39 42 43 43 42 40 39 41 44 45 46 44 44 42 40 39 39 41 38 37 38 38 34 35 33 31 31 30 32 33 32 30 29 27 27 26 26 26 26 26 25 26 27 27 27 27 27 28 
31 31 31 31 31 31 30 33 34 35 35 34 34 36 38 40 40 41 42 41 41 39 39 40 41 44 46 45 44 43 41 41 41 41 40 39 38 39 35 35 32 30 29 30 32 32 32 30 30 30 28 28 27 27 28 28 27 27 25 26 26 27 30 31 
30 30 29 30 29 29 29 33 34 34 34 33 33 35 37 38 41 42 41 41 41 39 38 41 41 42 44 43 43 44 42 40 42 41 40 38 37 37 35 35 32 31 29 29 31 30 30 29 30 31 29 28 27 28 30 29 28 27 26 26 27 29 31 32 
29 28 27 27 27 27 29 30 32 32 33 33 33 35 36 39 39 42 41 41 41 42 41 42 42 43 44 44 43 43 40 39 40 40 38 38 36 35 35 35 32 30 29 29 30 30 29 28 28 31 30 29 30 30 30 29 28 26 26 27 27 29 31 31 
29 27 27 27 26 26 28 30 31 31 32 34 34 36 36 39 39 39 41 41 42 42 42 42 42 42 43 41 41 41 39 38 37 37 37 35 34 33 34 33 32 30 29 29 30 28 27 27 28 29 29 31 31 31 30 29 27 27 27 28 28 31 32 30 
30 28 27 26 25 26 27 28 29 29 31 34 35 35 36 36 39 39 39 40 41 42 41 42 41 42 42 42 41 39 39 36 35 34 33 32 32 31 31 31 32 30 29 29 30 28 28 28 28 29 31 32 33 33 31 31 30 27 28 28 30 31 32 31 
30 28 27 26 26 25 25 25 26 28 30 31 33 34 35 35 37 38 37 39 41 40 39 39 39 39 40 41 39 39 37 36 33 32 30 29 30 29 30 32 31 29 29 28 29 29 28 27 28 29 32 33 35 35 34 32 31 31 28 29 30 31 32 31 
30 28 27 25 26 25 23 24 26 27 29 31 32 33 33 33 36 37 38 38 40 40 38 38 39 38 38 37 37 37 36 34 31 31 30 28 27 27 28 28 28 27 28 29 29 29 29 29 30 31 34 35 38 36 34 35 34 30 30 29 30 31 31 30 
31 27 25 24 25 24 23 24 26 27 28 29 31 30 31 33 34 34 36 36 36 38 38 38 39 38 36 35 34 34 34 32 30 30 28 27 27 25 25 26 27 28 27 28 28 28 29 30 30 33 34 37 37 37 36 34 35 32 31 28 29 29 31 32 
